NO includes/textures/dirt.xpm
SO includes/textures/dirt2.xpm
WE includes/textures/dirt3.xpm
EA includes/textures/wood.xpm

F 220,100,0
C 225,30,0

1111111111111111111111111
10000000001100000000S0001
10110000011100000100000001
10010000000000000000000011111111
111111111011000001110000000000001
100000000011000001110111111111111
1111011111  11011100000000001
11110111  1 1101 101010010001
1100000011010101 100000010001
100000000000000011000000100001
100111100100000001101010010001
1100000111010101111101111000111
11110111 1110101 101111010001
111111      1 1   11101111111