NO includes/textures/dirt.xpm
SO includes/textures/dirt2.xpm
WE includes/textures/dirt3.xpm
EA includes/textures/wood.xpm

F 19,0,90
C 60,42,33

        1111111111111111111111111
        1000000000110000000000001
        1011000001110000000000001
        1001000000000000000000001
111111111011000001110000000000001
100000000011000001110111111111111
10111111111111110100000000001
10011110000100010101010010001
11000000110101010100000010001
10000101010001000100000010001
10111111010100001101010010001
11000001110101011111011110N0111
11110111 1110101 101111010001
11111111 1111111 111111111111