NO includes/textures/dirt.xpm
SO includes/textures/dirt2.xpm
WE includes/textures/dirt3.xpm
EA includes/textures/wood.xpm

F 19,0,90
C 60,42,33

        1111111111111111111111111
        1000000000110000000000001
        1011000001110000000000001
        1001000000000000000000001
111111111011000001110000000000001
100000000011000001110111111111111
11110111111111011100000000001
11110111111111011101010010001
11000000110101011100000010001
10000000000000001100000010001
10000000000000001101010010001
11000001110101011111011110N0111
11110111 11101000101111010001
11111111 11111110111111111111
               101
               101
        11111111011111111
        10000000010000001
        10111111110000001
        10100000000000001
        10111111111111101
        101           101
        10111111111111101
        10000000000000001
        11111111111111111