NO includes/textures/dirt.xpm
SO includes/textures/dirt2.xpm
WE includes/textures/dirt3.xpm
EA includes/textures/wood.xpm

F 19,0,90
C 60,42,255

111111111
100101001
101001001
1100N1001
111111111